##########
#S    #  #
# #####  #
# #     ##
# # ###  #
#   # # E#
##########