#############
#S#     #   #
# #  ## # # #
# #   #   # #
# ### ### # #
#     #     #
######### ###
#          E#
#############