#############
#S#     #   #
# #  ## # # #
# #   #     #
# ### ### # #
# #    #    #
# ## #### ###
#    #     E#
#############